###############
###   #   #  S#
#    ## #   ###
####  # ### # #
#  #     #    #
#    ##  ######
## #####   # ##
#     #  #    #
##### ##### # #
#     #   # # #
# ####  # ### #
# #    #  #   #
#   ####  # # #
#  #  #  ##   #
#######F#######