###############
# #   #   #  S#
#    ## #   ###
####  # ### # #
#  #     #    #
#    ##  ######
## #####   # ##
#     #  #    #
##### ##### # #
#     #   # # #
# ####  # ### #
# #    #  #   #
#   # ##  # # #
#  #  #  #    #
#######F#######